303002010
010020303
303003020
010000100
200202002
001000010
040600304
100000000
020300103