020200201
100000000
050501000
301010604
020201000
303020503
010000020
000200301
203020030