010030402
302002000
010040200
300103003
001050200
300402003
001020010
000200203
203030010