010030302
204002020
010000002
203000100
040030020
200200303
020000000
100302001
020020200