104002002
000100200
204010000
020300303
000000000
304006030
010000002
102004020
020300302