020030202
102000000
010003003
003040010
400202002
010050100
300102040
000000001
202030020