101020020
000001001
003040000
300202030
000020103
020404030
000000003
100306030
020020202