00200303030200102
20040050501002010
01000000010400104
20040400000000000
00000020400505005
03060603002000010
20100010400400003
02070701001005050
30100000300000002
02030020000506030
30000300202000104
01000030020505020
20050506003000000
00000000000505003
20070504002000010
00000010200304002
30040303020020100