20020200201020201
03004001020200000
20000030500030705
02010000010000000
20404060700400605
00000000002001000
20707070500030605
00000000000000000
30606040506070604
00000000010000000
00100000104050704
20005040020001000
00100405005050303
04030000000002020
20000000102000002
03030305030030020
20202020200200202