20030101010302020
00000000000000001
30070706002010020
00000000000203004
02050807006060020
10000000000000204
00020504030000020
03001010002050400
20010204070201003
00302040000020030
02010204070502000
20301000000010202
01000030050706020
30020301000000000
02001020050307004
10000000000000000
02020302020104002