20020102002002010
02001020400010001
20030201010405050
03002040000000002
20000000400606030
03060040000000103
20001000301000000
05080403030407004
00000010302000000
05070301010307040
20001000300000002
00040010005005050
02000300300000002
00000000006030040
03030302030001003
10000000003020020
01010020020102003