20020202002020302
03003020030002010
20000000000100100
05050500102010002
20000010030406030
04050504004000000
20100010000001003
01000105030200030
00030020003002003
20500305060300020
01000000000000002
20301020040806050
04040503001000002
30000020100404050
04040300000000003
00000003003005040
30302030030300203
