20202020020200202
03040300200002030
20000000010000002
02003040500605060
20030000000000002
00003070400704040
20100003020000002
02050020000300100
20002005040020030
00010200503000202
04004010000000020
00020400706030203
20000000000000000
05060700704004040
20000001000020103
03020000200001010
20200202002030302