20020100201020202
01000000010304020
20003030503030003
00000000000001000
03020100505060020
00104040000100000
20000001020050304
05007080504000000
00000000000002003
04006060405040200
20000000000002000
00000000000100604
04007070500002010
00010100001020202
20001040700606020
02030200000000000
20202020100204002