2030101002010
0000000000001
3080600506040
0000000000002
2060400507040
0001002020000
4050000000102
0100302001010
2002020050503
0010200100000
0203004070705
2020010000000
0100202020203