3002020403010
0000000020203
3010000202000
0104040050406
2020000101000
0100504060604
0000000100000
2050602030604
0000000000000
2060400200200
0000010020003
3060503000200
0100030302003