2002040202002
0000001050300
4005080300003
0030400030300
0000050301003
3040301050400
0001040301000
0040201020303
3002040604000
0060503010100
3000010203003
0030403020100
3003030303002