0100200201010
2020020000001
0304000506040
2000000000000
0204060604003
3020100000000
0205070708040
2000000000003
0406040507040
2020200000003
0201010003020
1030400300203
0202002000010