2020201020201
0000030001000
2003000300505
0000100000000
2006060401000
0010203050604
0002010000000
2020407050300
0102020204005
0000102010000
2040030002004
0001000200000
3050202030202