2020102040100
0103010001002
0010000000000
0305003060403
0020100001010
2002004060002
0030300000400
2000002002002
0101000020200
3040606006020
0000000000000
2003020205002
0010203020010