3030201020202
0203010304030
2010404020003
0103000000020
0000404003004
1003050500020
0000000000000
0100040305004
2004005030020
0100000003002
3000104020000
0204020102030
3030302030302