01030303030202030
20304050504010000
00000000000000001
30030080604003040
01000000000100003
30020060200000030
03001001003002000
30100070030000003
04040400000204060
30000030102000102
06070602030030060
00000010400201002
20000000010020030
04040300504002003
10000000000000000
00102020406030303
03030303030302010