01002000102002010
30200010030010001
01003000200306050
00200102000010003
30004010040302050
02000000100030103
30407005080401050
00000000000030103
03010200100101040
30102000000000000
06030405060040303
20103000000000020
04030306070040000
20001000001000303
04080300010020010
10001003002000203
02030010200030010