20030300302002010
00000002020040603
20302010000100000
00010000301010000
10705003030700604
00000010301000000
00000001020400506
20605040202000000
00000101020201000
30805040607040405
00000200010000000
00001020303020000
20600403050400606
00001000000000000
00000100020020304
30604003002000010
01000030030303002