20040303020200010
00001050504003002
30080300010100100
00000030201001000
01040303040500504
20200010000000000
01003004003040405
30040300100000000
00100002004080030
00040500010300002
20503001000030030
00000300201000002
20605003040604020
00040050303000000
00100000000307004
20040050505010000
01000303030302001