01030000302020301
20506005010100000
00010010000030804
00000003002000000
30504030200400603
01000302001000000
10020010300600604
00101000001000000
03050701000604010
00100020503000000
20000300000303003
01010010000000000
20500500605050604
00000010020000000
10703000001000000
00000101040060502
10302030300002010