20301003030300302
00030060605050020
30600000000000000
00030050606060102
00300000000001020
10002060605040403
00010001020200000
20506070501050804
00000000010400000
20707070701050703
00000000010501000
30705070701010003
01000000000000400
10040050600605000
00100000000000505
02040040600403000
30303003030030201