01030000300202010
10000103004030304
05040020000001030
30000000308050200
00102040000001003
30000001000000200
04030080506020030
20000000000000103
02005070608005040
30010000000000003
03008070806006050
00100000000100002
30000000010006050
00206040302000002
02010000000206060
30205040020000001
01030302002002030