010303002
100030200
030500000
202040704
000301000
204020403
000306030
001000001
200203020