010203002
205030100
000001000
306040404
000000000
100203004
003000010
000010202
203002010