100200102
000002010
200300000
000002003
020500020
300030200
000101003
030040100
302002002