102004020
000000001
000306040
303000102
010404010
202010404
020302000
100000000
010300201