200302030
000030202
010202030
203020104
000104010
203010103
030305020
100000000
010103002