200500403
000000010
400600203
010002040
200000002
020200020
001004003
200010000
010202001