010200201
202010000
020300604
000000000
200202000
030020304
300203010
020030203
202002010