30300201002020200
02030010300401001
00200000000000000
20030300600600604
02000000000000000
20404030401010503
02030003020503010
20200200301000002
02060002000000100
00002030400200003
20060301010004030
00000010505010003
30080501000000020
00000010406002002
00000000000000000
10050400405020020
01003030020300302