20202002020200201
03050300402001000
20000000010040505
03030020400200000
20100200000050604
00010040050400000
03000400100020605
20000010020000000
00100600200500404
04020002001000010
20000000100500302
04060606005005030
00000000000000002
20070406007008040
00000000000000002
10040010103004020
00102002010200202
