20200300202020100
01020020040503002
20200000100000000
00030200030300303
20200020201002000
00001002050030505
20040200100202020
00002003030010203
03050400200301010
10000003050000000
00100000000200403
20000406040010000
01030000103001002
30200306010100200
00000000000000002
20040405003001000
00203020020200202