01030302002020010
10504040500200001
00000000010040050
00000020300000003
20504004040402040
01000000302020003
30100104010201000
04004030304040040
30000002000000002
06006040307060040
00000103020000303
20000030401000000
06004000030060804
20000020503000000
03005001000000000
10000200505030402
01004030030202010