20020200202020010
02003040030300404
00000000001000000
30105080300201000
03020000004060504
30104080400000010
02010000010030302
20305050605003020
02000000000000000
20300000404020202
00005050010204020
01000000404040202
20605030000001020
00000200505070302
10705000000000000
00000202004060030
10302020020202002