20202020202020101
02030505020100000
00000000102040704
20400505030001000
02000010000300704
20400500302000000
03001000000030704
20200302010200000
00002010002030003
02000400200300300
20502000000010000
00000010020400504
10600400401000010
00000000030600402
20705060501000000
00000000010202020
30402030202010202