30300200300302010
02005040030040503
00000000000000000
20407060402030000
01000001020100603
00303000202020000
30020010000000000
00103003030060704
00010100303000000
20306040010040300
00000002004005003
00405020000000000
20010304020020000
00402000102005004
00000100000000000
20504003003020102
01030030200203010