3000303020020
0020020100001
0001000030300
3050401000010
0000010060804
0050702000000
1000000000000
0000003080703
2060600100000
0000001040604
2060300001000
0001030300200
3040103030002