3030020103020
0103000000001
3010040708040
0304000000003
3000040706030
0000000000000
0605040506003
3000100000020
0404020010003
2000303006040
0308050400103
1000000001010
0103020400302