0100200200303
1000002030010
0401000000103
3040505080040
0300010000003
3050402060100
0300030101030
2000201060103
0010030101030
0300200000002
2050060080040
0000000000001
1030020040020