2030010030030
0000000000001
4070050070400
0003000100020
0100102050302
2006030202030
0010301010100
0304010403002
2010402000010
0101000001000
0030400400704
1000001000000
0100300200302