3002010010301
0000000000000
0206050040705
0010000000000
3004040080705
0020100200010
2004004001003
0100000030200
2020203002003
0001000010100
3060300605020
0000000000000
1030100302002