2030200202002
0001000000000
3060201002010
0003030600604
2050100010000
0001030400000
3080503060705
0000040301000
0000100010204
3040040304010
0102003030305
0000000001000
3003030020203