0200300202010
1000001030603
0020500604010
0300000010300
3020030403003
0300200020030
3030050300303
0200201040030
2040040100302
0000100001020
0101050060200
2040201000001
0102020030020