203030030
000000101
000000020
407070402
010000010
203040503
020000000
103000400
030030002