203002010
000000203
407005030
010100102
000000000
201001020
020500402
000000000
200302010