204030020
000201000
404010001
030706040
200000002
030607030
100010304
000101000
020030201