103003002
000020030
002000103
200405020
000000000
020305005
101000200
020010000
200200302