020203003
100000100
000303010
040050202
200000000
020040030
400501000
000000001
200402020