003030202
100205020
001000204
300606010
000000000
010705003
301000100
010402001
303020200