010200402
204002000
000200604
306000000
000504000
000000505
205001000
000200303
305020010