2020202020201
0404040301000
2000000000000
0404070700504
0020100010000
2000000000000
0030040300406
2001000000000
0100003050605
2020020202000
0000001010304
1002040503000
0020303020203