2030202030303
0000000103020
0000001010102
4080600403010
0000001020303
0030200100000
3003002002004
0100020040300
2000101000000
0403010040804
2000303000000
0403000000000
3030202020302