2020402002010
0100010030303
3020602002030
0200000040202
3030804000030
0000000000103
0400604060040
2010000000003
0100010060300
2060600200020
0000001050202
2050300100010
0103003020102
