0100200304020
2020020010001
0200100102000
2003040030030
0200000000002
0005060303030
2000102010003
0302010103000
2000000000020
0300305005003
0003020000010
1000103004002
0203020020010