0010202020302
2003040300020
0000000000203
0306040040040
2000200401003
0200000030020
3003020200002
0200200003040
3002030020003
0300300406040
2020000000000
0100030503003
2030303020100