0203020030010
2050603001002
0000000000000
3070503030010
0000020300504
0000101000000
2060020300703
0001003020000
4050020100000
0100303050605
0000000000000
2001003060403
0010300202010