0203020200202
0000103003010
2003010000000
0100307005003
0005030000000
2000004020103
0207040205020
2010001000002
0000000308040
2005030020002
0000000005020
0103003030001
2020020204010